**XXXXXXXX
X*****XXXX
XX*XX*XX*X
XX*XX**X*X
XX**XX***X
XXX**XXXXX
X*XX*****X
X**XXX*X*X
XX***XXX*X
XX*X*****X
XX*XXXXXXX
XX***XX**X
XXXX**XX*X
XXXXX*****
